*****************
*1_             *
*_* * * * * * * *
*               *
* * * * * * * * *
*               *
* * * * * * * * *
*               *
* * * * * * * * *
*               *
* * * * * * * * *
*               *
* * * * * * * * *
*               *
* * * * * * * *_*
*             _2*
*****************