*************
*1*   *   * *
*_* * * * * *
*_          *
* * * * * * *
*     *     *
* * * * * * *
*           *
* * * * * * *
*     *    _*
* * * * * *_*
* *   *   *2*
*************